Grid_getBlockNeighbors	Grid_getBlkNeighbors
Grid_getBoundBox	Grid_getBlkBoundBox
Grid_getRefineLevel	Grid_getBlkRefineLevel
Grid_markBlockDerefine	Grid_markBlkDerefine
Grid_markBlockRefine	Grid_markBlkRefine
Grid_getBlockType	Grid_getBlkType
Grid_getBlockSize	Grid_getBlkSize
Grid_getBoundaryFaces	Grid_getBlkBC
Grid_getExtent	Grid_getBlkIndexLimits
Grid_getBlockCenter	Grid_getBlkCenterCoords
Grid_getIndices		Grid_getBlkCornerID
Grid_bcSetAllVars	Grid_applyBCAllVars
Grid_bcSetOneVar	Grid_applyBCOneVar
Grid_releaseBlockPtr	Grid_releaseDataPtr
Grid_getCellVolume	Grid_getCellVol
Grid_getCoordinates	Grid_getCellCoords
Grid_getCoordPtr	Grid_getCellCoordsPtr
Grid_releaseCoordPtr	Grid_releaseCellCoordsPtr
Grid_getBoundaryFluxes	Grid_getTemporaryData
Grid_putBoundaryFluxes	Grid_putTemporaryData
Grid_getPointCoords	Grid_getSingleCellCoords
Grid_getSavedVarPtr	Grid_getSavedDataPtr
Grid_getSavedVars	Grid_getSavedData
Grid_putSavedVar	Grid_putSavedData
Grid_releaseSavedVarPtr	Grid_releaseSavedDataPtr 
Grid_getNumBlocks	Grid_getLocalNumBlks
Grid_putLocalNumBlocks	Grid_putLocalNumBlks
Grid_getGlobalNumBlocks	Grid_getGlobalNumBlks
Grid_fillGridIOData	Grid_prepareIOData
Grid_markRefineEllipsoidSurface	Grid_markRefineEllipsoid
